MMMMMMMMMMMMMMMMMMMMMMMMMMMMMMMMMMMMMMMM
MTPTTPTTMTPTTTDTMTTT TPTM TMTTTTMTTPPTTM
MTTTTTTTMTTTTTT M  P TTTM TT TTTMTTTT TM
M              P PP      P  D        P M
MDTTTTTTMTPTTTTPMTPT TT MTTPTTDTMTTPTPTM
MTTTTTTTMTPTTTTPMTPT  TTMTTTTTPTMTTT TTM
MMMMMMMMMMMMMMMMMMMM MMMMMMMMMMMMMMMMMMM
MTTTTPPTMTT TTTTMTTT TTPMTTTT TTMTTTTT M
MTTTTTTTMTT TTTTMTTT TTTMTTTTPT MTTTTTPM
M          P                 P        PM
MPTTPTTTMTTTTPTTMTTPPTTTMTTTTTTDM TTTTTM
MPTTTTPTMTTPTTPTMTTTPTPPMTTTTTTTMPTTTPTM
MTPTTTTTMTTTPTTTMTTT T  MTTTTTTTMPPTTPTM
MMMMMMMMMMMMMMMMMMMM MMMMMMMMMMMMMMMMMMM
MPT S TTMTTTTPTPMTTT TTTMTPDTT TMTTTTTTM
MTTTTT TM TTTTTTMTTD TTTM TT TPTMT T  TM
M        P                  P P   P PP M
MDTT TPTMPTTTTPTMTPT TTPMTPTPTTTMTTTTTTM
MTTTTTPTMPTTDTTTMTTT  TTMTTPTTTTMTTT   M
MTDTTTP MTT TTTTMTJD PTTMT TTTTTMTTTPPPM
MTPTTTTPMTTPTTPTMTBT TTTMTTTTPTPMTTTTPTM
MMMMMMMMMMMMMMMMMMMMMMMMMMMMMMMMMMMMMMMM