MMMMMMMMMMMMMMMMMMMMMMMMMMMMMMMMMMMMMMMM
MJTTTTTPTTTTTTTTTTTTTTTTTTTTPTTTTTTTTPTM
MTTTTTPTTTTTTTTTTTDTTTTTTTTTTTTPTTTTTTTM
MTTTTTTTTPTTTTTTTTTTTTTTTTTTTTTTTTTTTTTM
MPTTTTTTTTTTTPPTTTTTTTTTTTTTTTTDTTTTTTTM
MTTTTTTTTTTTTTTTTTTTPTTTTTTTTTTTTTTTTTTM
MTPTTTTTTTTTTTTTTTTTTTTTPTTTTTTTTTPTTTTM
MTTPTTTTTPTTTTTTTTTTTPTTPTTPTTTTTTTTTTPM
MTTTTTTPTTTTTTPTTTTTDTTTTTTPTTTTTTTTPTTM
MTTTTTTTTS TTTPTTS TTTTTTS TTTTTTS TTTTM
MTTTTTTTT STTTPTT STTTTTT STTTTTT STPTTM
MTTTTTTTTTTTTTTTTTTTTTTTTTTTTTTTTTTTTTTM
MTTTPTTTTTTTTTTTTTTTTTTTTPTTTTTTDTTTTTTM
MTTTPTTTTTPTTTTTTTTTTTTSTTTTTTTTTTTTTTTM
MTTTTTTPTTTTTTTTTTTTPTTTTTTTTTDTTTTTTTPM
MTTTTTTTTTTTTPTTTTTTTPTTTTSTTTTTTTTTTTTM
MTTPTTTTTTTTTTTTTTTPTTTTTTTTTTTTTTTTTTTM
MTTTTTTTDTTTTTTTTTTTTTTPTTTTTTTTPTTTTTTM
MTTTTTTTTTTTTTTTTTTTTTTTTTTTTTTTTPTTPTTM
MTTTPTTTTTPTPPTTTTTTDTTTTTTTTTTTTTPTTTTM
MTTTTTTTTTPTPPTTTTTTTTTPTTPTPTTTTTTTTTBM
MMMMMMMMMMMMMMMMMMMMMMMMMMMMMMMMMMMMMMMM