MMMMMMMMMMMMMMMMMMMMMMMMMMMMMMMMMMMMMMMM
MPTMMTMPPTMTTTPMPTTPTTTTMTTTPTTTTTPMTDTM
MTT MTDTPTMTTTMMMTTMTPTTTTPTTPTPTTTMTMPM
MTSTTMTTPDTTPTTTTMTTTTTPTMMPTTTTTTTMTMMM
MDTMTTMPMPTTPTTTTMTTTPTTTTTTPTPPTTSSTTPM
MPTMTTTMTTPTMMTTPTMMDTTTSTTTPTPPTTTTTTMM
MPPTTPTTTTMTTTPTTSTTTPTPPTTTTTTPTTDMMTTM
MTTPTMMTTPTPPTTTMTTTTPTPPTTTTTTMTTPTMTPM
MTTMTTTDTTTTTTDTPTTMMPTTPTMTMPTTMPTTDTPM
MPTPTTTTMTMMTPDTPTTMMPTTPTTDTMTTTMTTPTMM
MTPTMMTTTTTPPMPTTDTMTMPTTMPTTTMPTTDTPTMM
MMTMMTTSTTTPPMPTTPTMTMPTTMPTTTTMMTTPTMMM
MTMTPTPTMTTTMMPTTPTTTTMTTTPTTTTTMMTPTMMM
MTMTPTPTMTDTMTMPTTMPTTTTPTTPTPPTTTTMTTTM
MMTTMPMPTTPTTTTMTTTDTTTMTPMTTTTTTMTMMTDM
MMTTTMMPTTMTDTTTMPTTPTPTTTPTMPTTSTTTMTTM
MMTDTTTTPTMMTTPTMMPTTTTTTTPTMPTTTTTTMTTM
MTTPTTTTMTTTPTTTTTTPTPPTTTTTTMSTPTMTTTMM
MPTMMTTPTMMTTTMTTTTPTPPTTTTTTMTTPDTTPTTB
MMTTTPTTTTTTPTPDTTTTTTPTTTMMTTMPTTDTMTTM
MPPTTTMTTTTTPTPDTTTTTTMTTPTMDTDTPMTPTTTM
MMMMMMMMMMMMMMMMMMMMMMMMMMMMMMMMMMMMMMMM