MMMMMMMMMMMMMMMMMMMMMMMMMMMMMMMMMMMMMMMM
MMTTTTTPTTTTTTTTTTTTTTTTTTTTPTTTTTTTTPTM
MTTTTTPTTTTTTTTTTTDTTTTTTTTTTTTPTTTTTTTM
MTTTTTTTTPTTTTTTTTTTTTTTTTTTTTTTTTTTTTTM
MPTTTTTTTTTTTTTTTTTTTTTTTTTTTTTDTTTTTTTM
MTTTTTTTTTTTTTTTTTTTPTTTTTTTTTTTTTTTTTTM
MTPTTTTTTTTTTTTTTTTTTTTTPTTTTTTTTTPTTTTM
MTTPTTTTTPTTTTTTTTTTTPTTPTTTTTTTTTTTTTPM
MTTTTTTPTTTTTTPTTTTTDTTTTTTTTTTTTTTTPTTM
MTTTTTTTT  TTTPTT  TTTTTT  TTTTTT  TTTTM
MTTTTTTTT STTTPTT STTTTTT STTTTTT STPTTM
MTTTTTTTTTTTTTTTTTTTTTTTTTTTTTTTTTTTTTTM
MTTTPTTTTTTTTTTTTTTTTTTTTPTTTTTTDTTTTTTM
MTTTPTTTTTPTTTTTTTTTTTTTTTTTTTTTTTTTTTTM
MTTTTTTPTTTTTTTTTTTTPTTTTTTTTTDTTTTTTTPM
MTTTTTTTTTTTTPTTTTTTTPTTTTTTTTTTTTTTTTTM
MTTPTTTTTTTTTTTTTTTPTTTTTTTTTTTTTTTTTTTM
MTTTTTTTDTTTTTTTTTTTTTTPTTTTTTTTPTTTTTTM
MTTTTTTTTTTTTTTTTTTTTTTTTTTTTTTTTPTTPTTM
MTTTPTTTTTPTPPTTTTTTDTTTTTTTTTTTTTPTTTTM
MTTTTTTTTTPTPPTTTTTTTTTPTTPTPTTTTTTTTTBM
MMMMMMMMMMMMMMMMMMMMMMMMMMMMMMMMMMMMMMMM