MMMMMMMMMMMMMMMMMMMMMMMMMMMMMMMMMMMMMMMM
MTPTTPTTMTPTTTDTMTTT TPTM TMTTTTMTTPPTTM
MTTTTTTTMTTTSTT M  P TTTM TT TTTMTTTT TM
M              P PP      P  D        P M
MDTTTTTTMTPTTTTPMTPT TT MTTPTTDTMTTPTPTM
MTTTTTTTMTPTTTTPMTPT  TTMTTTTTPTMTTT TTM
MMMMMMMMMMMMMMMMMMMM MMMMMMMMMMMMMMMMMMM
MTTTTPPTMTT TTTTMTTT TTPMTTTT TTMTTSST M
MTTTTTTTMTT TTTTMTTT TTTMTTTTPT MTTTTTPM
M          P       P         P        PM
MPTTPTTTMTTTTPTTMTTPPTTTMTTTTTTDM TTTTTM
MPTTTTPTMTTPTTPTMTTTPTPPMTTTTTTTMPTSTPTM
MTPTTTTTMTTTPTTTMTTT T  MTTTMTTTMPPTTPTM
MMMMMMMMMMMMMMMMMMMM MMMMMMMMMMMMMMMMMMM
MPT S TTMTTTTPTPMTTT TTTMTPDTT TMTTTTTTM
MTTTTT TM TTTTTTMTTD TTTM TT TPTMT T  TM
M        P                  P P   P PP M
MDTT TPTMPTTTTPTMTPT TTPMTPTPTTTMTTTTTTM
MTTTSTPTMPTTDTTTMTTT  TTMTTPTTTTMTTT   M
MTDTSTP MTT TTTTMTJD PTTMT TTSTTMTTTPPPM
MTPTTTTPMTTPTTPTMTBT TTTMTTTTPTPMTTTTPTM
MMMMMMMMMMMMMMMMMMMMMMMMMMMMMMMMMMMMMMMM